1111111111111
100000C0000C1
1C00111111001
1P0011E000001
1111111111111